NO ./assets/file_n
SO ./assets/file_s
WE ./assets/file_w
EA ./assets/file_e

F 0,255,0
C 0,0,255


1111111111111111111111111  
1000000000000000000000001 
1001000000010010000000001  
1000000000000000000000001
10000000000N0000000000001
1001000000000000000000001
1111111111111111111111111 
