NO ./assets/file_n.xpm
SO ./assets/file_s.xpm
WE ./assets/file_w.xpm
EA ./assets/file_e.xpm

F 100,32,32
C 0,0,0


1111111111111111111111111  
1000000000000000000000001 
1001000000010010000000001  
1000000000000000000000001
10000000000p0000000000001
1001000000000000000000001
1111111111111111111111111 
